tam forti animo mortem pertulisse traditur : quam isti incendium poggius florentinus
etatis nostre nobilis scriptor : de morte ieronimi ad nicolaum nicolai
conciuem suum : elegantem scripsit epistolam quamuis paululum sua con¬ 
suetudine : in mores cleri inuectus uideatur cineres exustorum ne
raperentur a bohemis in locum proiecti discipuli eorum ex eo solo
terram abstulere : in quo ignis fuit : eamque ueluti sacram secum
attulere in patriam ‧ iohannes ac ieronimus apud bohemos martirum
honores meruere ‧ nec immores quam petrus et paulus apud romanos
habiti ‧ nunciatis eum in bohemia quam constancie gesta fuerunt : de
iohanne ac ieronimo : discipuli eorum sequacesque omnes in unum conuenientes
memoriam in primis defunctorum consecrant : celebrandamque quot annis  
decerunt : exim per amicos nonnullas sibi ecclesias a rege tradi extor¬
quent in quis sue predicare plebi : sacramentaque ministrare
libere possint : neque hoc modo contenti : apud Platonicim : nobile
monasterium fratrum predicatorum : extra menia oppidi situm a fun¬
damentis : deiiciunt ‧ eaque prima ecclesiarum ruinas inhussitarum
nouitate facta ‧ decurritur in ecclesias Monasteriaque passim nobili¬   
ssima superis dicata templa : ferro aliter igne uastantur ‧ nullum
ego regnum etate nostra : tota europa : tam frequentibus: tam au¬
gustiis : tam ornatis templis : dotatum fuisse : quam bohemicum : et reor
templa  in celum erecta : longitudine cui amplitudine mirabili:
fornitibus tegebantur lapideis : altaria in sublimi posita : auro et
argento : quo sanctorum reliquie tegebantur : onusta : sacerdotum 
uestes : Margaritiis tecte ornatus omnis diues : preciosissima
suppellex : fenestre alte aliter amplissime : conspicuo uitro et
admirabili opere lucem prebebant ‧ neque hec tam in oppidis atque 
urbibus sed in uillis quoque admirari licebat fuit inter cetera : 
monasterium aule regie apud ripam multauie qua misa fluuius
illi iungitur : situm in quo regum corpora condebantur : singularis
excellencie : nam preter edem magni et memorabilis operis : amplum
dormitorum : ceterasque monachorum officinas : magnifice constructas
quadrata portuus fuit : que non parum conclusit ortum : ambitum
uocauere : in huius lateribus uetus nouumque testamentum : ab inicio
genesis usque ad apocalipsim iohannis : litteris maiusculis in tabuliis
scriptum continebatur notis quo alcius irent : paulatim crescentibus
ita ut a summo usque deorsum : facilis leccio preberetur : sed hoc decus 
