oratoriaque construunt : tamque propitior in eis diuina bonitas nunciatur
sacerdotales uestes : altarum ornamenta : pallas : corporalia:   
calices : patenas uastique huiusce modi nil habere momenti:
sacerdotem quocumque loco quocumque tempore sacrum tristi corpus
conficere posse petentibusque ministraere : sufficere si uerba sacra¬
mentalia tamen dixerit  : suffragia sanctorum in celis tum cristo
regnantum : frustra impetrari :  que iuuare non possunt :
In canonicis horis decantandis : dicendisque : frustra tempus teri nulla die  
ob opere cessandum : nisi que dominica nunc appellatur : celebritates sanctorum 
prorsus reiciendas : Ieumis quoque ab ecclesia institutis nichil in esse meriti 
Sbinco cognomine lepus : clarus parentibus apud bohemos ortus per idem
tempus ‧ pragensis ‧ ecclesiam : pontificio retinebat: Consilio et animo illustris:
Qui orienti calamitati obuiam nostre cupiens : priusque amplius debaccaertur :
libros iohannis Uicliffi : ad se serui : omnesque doctorum uirorum adhibito consilio 
publice concremaius iussit ‧ Supra CC ‧ uolumina fuisse traduntur pulcherrime
conscripta bullis aureis tegumentisque preciosis ornata ‧ iohanni predicatori 
interdicta et adiecte minime : si qui priores in populum errores uolgare
fuit auderet ipse praga excidens : aput uillam : unde sibi origo
fuit : ac cognomen permittente loci domino : qui eius insanie fauebat : uocacitur 
plebes ‧ ac docere non destitit multa in romanum presulem : multa in
reliquos ecclesie pontifices : maledicta congerens ‧ utque populi animos
magis : ac magis conciliaret : decimas aut aliter quam elemosinas :
sacerdotibus debitas liberum esse predia possidentibus si uelint: ea dare
si nolint : nullo iure cogi posse ‧ nondum error de sacramento : altaris
iurepserat ‧ Sed attidit nouam pestem : petrus trasensis : id est opidum
mis ne super albim situm ‧ Qui cum alis theutonibus paulo ante bohemiai
reliquerat : cognitus inter suos : quia ualdensi lepra infertus esset:
patria perulsus : uelut hereticorum asilum pragam reperiit : puerorumque
docendorum curam accepit ‧ apud ecclesiam sancti michalielis per id temporis
populum predicando instruebat : Iacobellus insinem irarum doctrina : 
et morum prestancia : in ch(risto) clarus petrus aggressus mirari se ait
doctum et sanctum uirum qui domina cloquia plebibus exponeret :
errorem illum non animaduertisse : communionis eucharistie qui iam
pridem ecclesiam perfundasset ‧ in qua sub una tamen specie dominicum
corpus populo ministratur : cum aput iohannem ewangelistam et
apostulum Cristo dilectissimum : sub duplici specie panis uinique 
summi iubeatur ‧ dicente apud eum saluatore : nisi manducaueritis
carmen filii hominis : et biberitis eius sanguinem : habebitis uitam
in uobis ‧ commotus hiis iacobellus cum perquisitis uetustus seculorum
