siluam habitat : Getarum contermina genti : sweuorum quidem gens amplissima :
E reno siquidem : usque ad album peruenit fluuium : Eorum porcio eciam
trans albim loca depascitur quemadmodum : eumondori : Et lancosargi
hec strabo : plebs toto regno bibula : Et uentri dedita : Supersticionumque
sequax et auida nouitatum : Quociens crethense uinum caupones
uenale proponunt : Inuenies complures : qui iuramento adacti nunquam
cellam uinariam egredientur : nisi exhausto dolio : idem efficiunt
in selectis ex italia uinis Qui paulo excellunt atque inter plebem :
nobilitatemque medi sunt : audaces : uersuti : ingenio uario : lingua precipiti :
rapinarum auidi : Et quibus nichil satis esse possit : nobilitas glorie appetens
belli perita : periculorum contemptrix : ac promissi tenax : quamuis eius
ingluuiem Explere dificilimum : at uniuersum simul Si expendas populum
Quomodo autem et unde : hoc genus hominum : in germaniam uenerit :
Scripsi iam pridem integerrimo et prestantissimo patri dominico Car¬
dinali firmano : tue serenitati amicissimo : id hoc loco repetere non
grauabor quando historie quam teximus omnino quadrat : bohemi : sicut
ceteri mortalium : originem suam quam uetutissimam ostendere cupientes
Sclauorum se prolem asserunt : Sclauos autem inter eos fuisse : qui post
uniuersale diluuium condende famosissime turris : babel autores habentur
atque ibi dum ligue confuse sunt : Sclauonos id est uerbosos appellatos
proprium ydeoma accepisse : Relicto deinde campo : Senaar ex asia in
europam profectos : eos agros occupasse : quos nuc bulgari serui
dalmacie croaci : Ac bosnenses incolunt : nondum ego quempiam
legi autorem cui fides adhibenda sit : qui tam alte sue gentis inicium
redderit : hebreos excipio omnnium mortalium primos Multi ex germaniis
satis se nobiles arbitrantur : Ex romanis ortos : Romani ex teucris
originem ducere : gloriosissimum putant : Franci qui et germani
fuerunt : troianum se sangwinem esse dixerunt : Eadem britannis
gloria satis est : Qui brutum quendam exilio profectum generi suo
principium dedisse affirmant : At bohemi longe alcius orsi ab ipsa
confusionis turre se missos iactitant : Ceterum nec qui tunc fuerint
nec quem regem habuerint : nec cuius terre cultores extiterint
nec sub quo duce : nec quibus periculis in europam uenerint : 
nec quo tempore : tradunt fuisse illic Sclauonos aiunt : dum labium
uniuerse terre confusum est : Vana laus ac ridenda : Quod si qui
bohemos imitari uelint nobilitatem generis Ex ipsa uetustate querentes
non iam ex turri babilonica : sed ex archa noe atque ex ipsa deliciarum
paradiso primisque parentibus : Et ab utero eue unde omnes egressi :
