fratri parere iubet Atque hiis demandatis uita decedit Quarto idus maii corpus
eius pragam translatum apud parentes sepultum : Spitigneus ut primum
rerum potitus  omnes theutonici generis bohemia excedere iubet : nec matri
potestatem manendi facit ‧ Exin morauiam infestis petens armis : fratres
bello aggreditur : uratislaus audito germani aduentu : relicta in Olo¬
nucio coniuge : ad regem andream in hungariam confugit : Conradus
et otho fratri se dedunt uxor uratislai capta aliquamdiu in uinculis
habita : postremo swadente Seuero episcopo dimissa : dum uirum in hungariam
petit : uicina partui in itinere decedit : Mestus ea re coniunx : ab
andrea 
rege  consolacionem accipit : qui filiam suam adilheidam
nuptum ei tradit : Quod cum Spitigneus accepisset : ueritus ne uires
hungaricas in se frater armaret : Missa legacionem : Sine causa illum
ex Morauia abiisse : dicit nichil hostile timendum fuisse : Nam cur
fratrem frater odiret : secundo post se loco genitum : Seruasse se bona
non abstulisse : redire eum ad suos debere : Cuncta ei salua esse : Nec
frustratus est fratrem : redeunti : que armis abstulerat : Cuncta restituit :
Iutha uero a filio deiecta in hungaria : Cum secundo nupsisset, breui mor¬
tua est : Cuius corpus in bohemiam translatum : in sepulchris principum condidere
Spitigneo uita defuncto : uratislaus successit Qui morauia rursus
inter fratres diuisa :
Iaronurum quem pater ecclesie dedicatum exortem
regni fecerat : In diaconem uel inuitum ordinari iussit : Is relicto Christi
habitum ad polonie duces confugiens : militarem disciplinam sectatus est
Fuerunt uratislao adilheide tres liberi : Bizetislaus et due femine ludi¬
milla ac Iuditha uerum adilheide mortua : uxorem alteram ex polonia
duxit nomine swatauam : Ex qua boleslaum borziuislaum uladeslaum
Sobieslaum suscepit : Inter hoc Seuerus episcopus : qui bohemiam Morauiam¬
que sacerdocio tenuerat : iohanne in morauorum ecclesia sibi substituto : iam
grauis senio ex uita decedit : ob quam rem Conradus et otho uratislaum
precibus honorant Iaromiro fratri Vt eciam bohemie ab imperatore
impetret annuit uratislaus : neque imperator aduersatus est : Iaronurus
ex polonia reuocatus : Relicta milicia episcopus ordinatur ac mutato nomine
Gebardus appellatur qui mox spiritu superbie inflatus Morauia non minus
sibi quam suo antecessori debitam dicit : illum exterum : se ciuem : illum
infimo loco natum Se regia stirpe ortum : Ingressus morauiam Iohannem
episcopum qui cedere nollet : contumeliis ac uerberibus afficit ‧ uratislaus
qui iohannem amaret ea re commotus Romanum pontificem contumaciam
gebardi uti corripiat : scriptis hortatur : Missus est in bohemiam ro¬ 
