ubi hec acta sunt : Monasterium ordinis sancti benedicti : quod uilischam
appellant : constructum : Et aram maiorem ibi sitam ubi arbor religatum
Ianurem tenuit : Melscho autem coacto exercitu : longe lateque bohemorum
populatos agros : pragam denique obsidione cinxit : Eamque biennio
fame laborantem obtinuit : excepta arce uicegradensi : que in fide
Ianuris mansit : fuerat et alter boleslao frater : quem pater hainrico
imperatori nutriendum dederat ‧ Is audita mesthonis prodicione : Clam
ab imperatore dimissus : Castellum dieviczum : natura et arte munitum
ingreditur Exin coacto raptim milite : colles occupat : qui prage super¬
eminent : tubasque clangere iubet : Mox alta uoce preconem pragen¬
sibus nunciare uictos prelio polonos fugam cepisse : uictorem principem
cum exercitu adesse : qua uoce accepta polonorum presidium : quod urbem
tenebat : metum proculsum excessit : pragenses aucti animo insecuti :
Germano suo sive proditoribus suggerentibus : Siue quod etatis beneficio
illum sibi preferre uerebatur : effodi oculos iussit : Multa huius facinora
referuntur : partim reprehensione, partim laude digna : Inter cetera et
illud narratur : redeuntem ex uenacione puellam uidisse in uilla quadam
iuxta puteum uestimenta lauantem : nomine bocenam : quod beatricem
interpretantur ‧ eleganti forma et moribus supra quam par esset agresti ue¬
nustis : captum specie et alloquio modesto quamuis amici aduersarentur :
Coniugem accepisse : biczestislaum ex ea natum : Is cum adoleuisset :
Iutham imperatoris othonis rufi filiam : que apud ratisponem in
monasterio nutriebatur : quamuis numquam uidisset : Sola fama commotus :
ui rapuit : solusque cum illa ad patrem perrexit : comitibus uelocitatem
eius insequi nequeuntibus : ab imperatore ex fuga retractis atque
occisis : non inprobauit pater factum : Sed admiratus audaciam
tanti se filium genuisse : gauisus : Matrimonium cum rapta in morauia
celebrari mandauit : Tanto prestanciorem filium existimans quanto
nobilius est imperatoris : quam uillici filiam amauisse : Imperator ea
contumelia motus : iureiurando affirmat : Exercitum in bohemiam
se ducturum : neque reducturum nisi prius in medio regionis sedem suam
collocet : Contra raptor affecturum se damnis : Theutoniam pari
religione promittit : Imperator collecto exercitu bohemiam instat
torrentis cuncta secum rapientis ingreditur ‧ Contra · odalricus filiusque
castra mouent Iam duo exercitus ad iactum teli conuenerant Cum
Iutha ex iniuria bellum ortum : crinibus sparsis : scissa ungwibus
facie : uicto periculorum magnitudine muliebri pauore : ausa telis
