Facile sibi principia uendicabunt : nos ista tanquam anilia deliramenta pretermittimus
omnes reges ex seruis ortos : omnes seruos ex regibus scripsit plato :
ueram nobilitatem sola atque unica uirtus gingnit : Multa sunt que de
bohemis uera ac memorabilia traduntur ad ea nugis omissis festinat
calamus Czehius Croatius haut obscuris parentibus ortus gentem bo¬
hemicam condidit : Qui homicidio domi perpetrato : iudicium ulcionemque
fugiens : in eam regionem uenit : Cui nunc bohemie nomen est : ac montem
incoluit Czhezip uocatum : quod uocabulum latini : respiciens interpretantur
Surgit enim ex medio camporum equore fluuios intuens : qui precipui
bohemiam irrigant : albim Multauiam atque egram : terram incultam
tradunt fuisse : Nemoribus ac sentibus asperam : ferisque quam hominibus
apciorem : Credimus id quidem · Nam prisci germani qui ea loca tenuerunt : 
pastoralem uitam agentes : agrorum culturam neglexerunt : ac more
nomadum Alimoniam : ex peccoribus trahentes domesticum in carris tol¬
lentes instrumentum : quocunque sors tulit : Et opinio suis cum armentis
conuertebantur Non tamen assentimur bohemorum historie : que Czechium
illum : omnemque familiam suam : Nam frater cognatique fuge comites
erant : glandibus ac siluestribus tantum pomis : uitam duxisse affirmat
Oblitterato iam tum glandium usu : Nec post diluuium ex hiis fuisse hominibus
fatum crediderim : illud michi perswasibilius fuerit : Czechium paucos
inuenisse cultores : quos lacte : ac uenatu uiuentes : arare terram : 
triticum serere : fruges metere : uescique pane docuerit : atque ita sibi
rudes homines : ac pene feros : ad usum mitioris uite redactos subiecerit :
hec rursus illud aput me pondus habet : omnia tum fuisse communia
atque tam uiros quam feminas incessisse nudos : Neque enim illa regionis
temperies est ut hominem asseruare nudum queat : ex dalmacia uenientem
Vbi non defuit uestis usus nisi fortasse argumentum quis abduxerit erit
adamitas qui nostra tempestate : apud bohemos submersere : communione
rerum omnium : Nuditateque gaudentes quos breui deletos constat : Czecpino
frater fuit : nomine leches : paupertatis et exilii comes : hic ubi germanum
agris ditatum : bobusque potentem animaduertit : ad orientem profectus in magna
camporum planicie sedem collocauit : poloniamque nomen ex loco dixit : Nam
planicies Sclauonica ligua pole nominatur cuius heredes in numerosam 
multitudinem coaluerunt : ac russaniam pomeraniam Cassubiamque sui
generis hominibus impleuerunt : Czechii quoque bohemos id est diuinos
appellant : Mirum in modum germinantes non solum prouinciam a se dictam :
Sed morauiam lusaciamque pulsis ueteribus incolis occuparunt : dum uixit
czechius nichil temere : nichil tumultuose actum : Eius imperio sine
controuersia obtemperatum : at eo uita functo : Cum sibi quisque principatum
uendicaret : diu sedicionibus agitata prouincia est sine principe : Sine
certa lege : iudicio tantum multitudinis gubernata : postremo cum potenciores
imbecillos opprimerent setum atque incertum esset populare : remedium ex
