sese inferre uolantibus : Inter primas acies prosiliens : patris alloquium priusquam
furor ardeat amplior : exposcit : Quo impetrato fateor inquit pater
iustum te bellum mouisse : Cuius filia rapta est : Illumque pena dignum
qui contempsit : nisi conpulisset amor : Cuius ceca consilia sepe ueniam
meruere : Sed age obsecro : pone ante oculos : quem armis insequeris
Gener tuus michi maritus cui tantopere irasceris : Et fortasse eciam
nepos tuus eius filius in uentre meo conceptus est : parce oro filie :
parce nepoti : patrem illi coniugi uirum : dimitte : non est degener maritus
nec solui consummatum matrimonium Romana ecclesia sinit : hec tibi uictorie
postestas est : utrique uires utrique belli artes suppetunt Mars dubius
casum respicit : Ne obsecro pater mei causa tantam miliciam morti obicito
parce cui ego prior lesa peperci : illacrimatus pater audita filia facturumque
se quod illa uellet nisi obstaret iuramentum respondit : Iutha et maritus
inquit meus iureiurando astrictus est : theutoniam armis lacessere : Sed
uana religio : que celeri locum facit : uim criminibus sacramenta non addunt :
Expromissorem malefici diuina maiestas odit : factorem exterminat : Inueni
tamen si libet uiam qua te simul promisso uirumque soluat : ueniet cum
patre gener ad pedes tuos ueniam commissi petet : te regem : te dominum profitebitur
neque impedimento erit : quominus sedem in medio bohemie colloces : ibique
ius dicas : postremo curiam tuam in theutonia petens uillas aliquot quas
iusseris : interequitandum diripiet : placuit Imperatori consilium filie : atque
in eius uerba fedus ictum : Exercitus consalutati in boleslauia que umbilicum
tenere bohemie creditur : sedes imperatoris lapidea erecta : perpetuum rei
monumentum principibus terre insigne datum imperialis aquile : Exin : Bizetislaus
Morauiam ex paterno indulto rexit : polonosque qui magnam eius partem occu¬
pauerant : bello deleuit : Eorumque multa ligatis post tergum manibus :
in ungariam uenumdandos misit : dum hec aguntur : anno post cristi
ortum xxx : ac Milesimo boleslaus apud crocouiam excecatus interit :
Odalricus quoque filius eius uita functus est : Qua re cognita Ianur et
ipse cecus pragam ueniens ducatum gentis sua parte ingenio nepoti dimisit
Bizetislaus ea re animo auctus : quamuis nulla iniuria lacessitus :
exercitum in hungariam duxit : Magnaque inde predam retulit : Quinque
illi ex Iutha fuerunt fili : Spitigneus : Vratislaus Conradus Iaromirus
et otho quorum fiducia plenus : eciam polonos ulturus auum : pulsare
bello non timuit : Crocouiamque armis captam funditus euertit : Gnesenium
quoque metropoliticam urbem diripuit : Multorumque martirum sacratissima
 inde corpora asportauit : Et crucem auream : ccc pensantem libras : 
quod cum imperator hannricus eius nominis secundus accepisset : indignatus
