Equisque arreptis : in campum prodeant : non longe a praga monstratum :
maturatur scelus : uirorum quantum imperatum erat interficitur : ueniunt
in campum armate femine · prostratuque uirorum exercitu : qui patri¬
cidas insequebantur : ducem in arce uicegradensi obsident : quam cum
expugnare nequirent castellum sibi procul inde in prerupto undique
colle : naturaque munitissimo edificant : quod dieuiczum appellant : quasi
uirginum castrum dieuicze namque ipsorum ligwa uirgines nuncupantur :
Res uisa patribus plebique perniciosissima : cum propter admissum zelus
tum quid illarum exemplo reliquas adduci feminas uerebantur Et hostem
cuique domi esse : formidabile fuit : hortantur itaque principem : puellas
bello coerceat : se tum copiis affuturos promittunt : primislaus se a diis
admonitum ait : perituros omnes qui puellas armis lacessant : tempus
aliud expectandum : Illi spreto consilio : coacto sine principe exercitu :
Castra ad dieuiczum ponunt : puellasque cingere obsidione pergunt
ualascha nil territa in maiori discrimine : maiorem adhibet animum
Comites ne mente labantur : plena fiducia hortatur : aduenisse tempus
affirmat : quo toti bohemie leges imponant : uidere se omnes prouincie
optimates in suam potestatem uenisse : uires tantum acuant uictoriam
in manibus esse · neque nouum uiros mulieribus obedisse : amaczones
Aliam sibi uectigalem fecisse : pugnasse : ad troiam : thesei atque herculis
arma contemsisse : Si consilium : atque animus mulieribus adsit : uires
haud quaquam deesse : Se nullus bohemi consilium suo preferre : ubi per¬
swasam multitudinem animaduertit : palantes hostes : Et nil tale
uerentes : agreditur : fit trepidacio totis castris : Mox feda oritur
fuga : Instant uirgines : uirosque passim trucidant : Neque aliter pung¬
natum est : quam si muliebres uiri : animos uiriles : femine induissent
pauci ex ea pugna euaserunt : quos uelocitas equorum : non sua uirtus
a morte redemit : Singularis audacie in hoc prelio septem 
puellas fuisse memorant : inladam : nodcam : Sroatariam : uorascam : radgam
Czastanam : Tristanamque : Reginam sua manu septem uiros interemisse
Spolia ingencia capta : premia pro meritis reddita : Septem que uirtute
prestiterant : torquibus aureis : atque armillis donatas : ualascham ueluti
deam habitam : Neque post id prelium bohemis aduersus puellas auda¬
ciam fuisse : ille populari agros : abducere predas : rapere : occidere :
uillas incendere potenciam in dies augere : fingere interdum se uirorum
amore teneri : amatorias epistolas nobilibus adulescentibus mittere :
detestari fastum : atque insolenciam ualasche : simulare fugam : Rogare
in siluam potenti manu uenirent : ac se raperent : Iuuenes qui puellarum
