stantem equum et aratori blandientem adulantemque uiderunt : accedentes propius : Salue
inquiunt bone uir : quem nobis superi dederunt principem Solue boues : atque
ascenso equo nobiscum uenito : libussa te uirum : bohemi ducem poscit : agrum
tolere : gregem pascere : nauem regere texere : suere edificare multi se igno¬
rare fatentur Magistratum in urbibus agere : Regem gerere : gentibus ac
nacionibus imperare : quod est difficilimum : nemo sibi a natura negatum
dicit : Et si plerique sine laboris odio : sine ocii amore : oblatis regnis
abstinuere : primislaus quamuis agrestis : benigne nuncios excipit : facturumque
postulata respondit : tanta est mortalibus regnandi cupido : nemo se
regno indignum deputat : solutos boues : ut fabulositas est omnis anti¬
quitas : Eleuatos in aera ferunt : Et in altissima proscisse rupis speluncam
delituisse : nunquam postea uisos : stimulum uero : quo boues urgebantur : terre
defixum : mox fronduisse : at tris corili ramos emississe : Ex quibus statim
duo exaruerunt : tercium in arborem eius generis : proceram excreuisse :
Non recipis ad me ueri huius periculum : Aput autores ista querantur 
uidi tamen inter priuilegia regni litteras caroli quarti Romanorum impe¬
ratoris diui sigismundi patris : in quis hec tanquam uera continentur : uilleque
illius incole : In qua gesta creduntur : libertate donantur : nec plus tributi
pendere iubentur : quam nucum illius arboris exiguam mensuram : Sed nec 
michi carolus : fidem facit : nam reges plerumque creduli sunt : nec quidquam
non uerum putant : quod generis sibi claritatem astruit : primislaus
igitur audita legacione inuerso uomere : pane caseoque apposito : uiam quasi
grandem facturus : cibum sumpsit : Ea res bohemorum animos confirmat
mensam ferream de qua libussa uaticinata fuerat in uomere cognoscentes
Stupentes edentem circumstant : Saturnum equm imponunt : iubentque festinare
intereundum : quid sibi uelit stimulus frondens interrogant : Et cur duo
rami mox aruerint : ille qui diuinandi periciam calleret : tris sibi
liberos nasciruros ait : Ex quis duo funere inmaturo deficiant : tercium
nobiles fructus editurum quod si agrum totum exarauisset : uite uocacionem
genus eius masculinum perpetuo regnaturum  
fuisse : Cum ante tempus
accersitus sit : Eam spem ademptam : Interrogatus cur nam calceos
querno robore factos secum afferret : seruandos in arce uicegradensi
respondit Ostendosque posteris : scirent omnes : primum qui principatum inter
bohemos accepisset : Ex agro fuisse uocatum : Neque insolescendum esse : 
qui ex humili fortuna solium ascenderit : seruati calcei : diu aput bo¬
hemos religiose habiti : Ac per sacerdotes templi Vicegradensis ante
reges delati : dum pompa coronacionis educitur : Cum Vicegradum
appulisset : primislaus : ingenti fauore plebis : atque honore exceptus 
est : libussamque sibi matrimonio iunxit hec diu moratus : pragense
