oppidum aggere atque muris cinxit : de cuius nomine cum disceptaretur : iussit
libussa ex artificibus qui prior acurreret : rogari quid aggeret ac
ex primo eius uerbo uocari oppidum interrogatus faber lignarius quispiam 
limen se agere dixit : quod bohemice praba dixitur : Indeque nomen
urbi datum : Sed corrupto uocabulo posteri pragam dixere : Ex
inde leges condite quibus bohemi longo tempore usi : prouincia pace
et ocio fruens opibus aucta : A libussa castellum libus edificatum :
non longe ab albi flumen : quod morienti sepulcrum fuit : Imperium
ad primislaum solum rediit : quod uiuente coniuge : Ex eius maxime consilio
administrauit : feminarumque illa iuuentute plurimum poterat : auctoritas
extincta : Sed fuit inter uirignes : que libusse ministrare solebant : 
ualascha puella ingentis spiritus : Et amaczonice mentis que clancunlum
accersit is comitibus : Neram inquit o sorores perdidimus : qua nos a
uirorum contumelia indicauit nec passa est seruire uiris : Contra uiri
eius imperium subire : Nos reginarum honore fungebamus : nunc iugum
asperum et miserrimum ferre oportet nisi libertatem nobis ipsis uendicemus
uilissima mancipia sumus : Quod si uibis animi est : quod michi
facile pristinam auctoritati obtinebimus : Ego secretorum libusse conscia
thebic : quoque sortes noui : herbarum uires non minus quam brela calleo
quod tres habuere sorores : hoc mihi soli datum est : assistite tantum audenti
imperium uibis in uiros polliceor : probant singule ualasche con¬
silium : Coniurant poculum recipiunt : quo uirile genus odio haberent :
Interea loci primislaus uirginem sibi per quietem sangwineum mini¬
strare potum uidet : territus somnio : ac malum qudd erat futurum
suspicatus : primores terre admonet : ne tantum licencie femineo sexui
prebeatur : Mos enim uirginibus erat equos ascendere fatigare cursu :
flectere in girum hasta contendere gestare pharetram : Et arcum
sagittare : iaculari : uenari nichil officii uirilis obmittere : quod
primislao cum periculosum : tum bonis aduersum moribus uidebatur 
Ac proceres ridere principem femineum sexum nil ausurum magni credere
mirari tanto magis : atque amauit puellas : quanto agiliores auden¬
cioresque dicerentur . ualascha monere interdiu noctuque conspiracione socias
Spem bonam facias : audaciam augere : poculis atque carminibus mentes
earum a uirorum amore auertere in dies plures allicere : prouinciam
uniuersam ueneno inficere : ubi iam uirginum ac nuptarum satis con¬
uenisse arbitratur : mandat omnibus suos uiros : parentes : germanos :
filios : mares omnes : somni uinoque sepultos noctu accidant : armis
