facinora magis adiuarentur : quam odirent : uicti blanditus : captique uero
non nullarum specie : erant enim plereque pulcerrime : imperata facessunt
Sed ingressi siluas insidiis circumuenti trucidantur : alii noua fraude in arcem
uocantur : ualascham ueluti per tradicionem comprehensuri : qui mox intro¬
missi ad unum necantur : ubi iam nulla fides uirginibus est : Commentum
in auditum excogitant : Sarca erat inter puellas admodum honesta
facie : Sed animo impuro Et ad omne scelus parato : hanc in altissimo
nemore : strictis pedibus : ac manibus arbori alligant : tubamque uena¬
toriam : ac uasculum medone plenum : iuxta ponunt : ipse insidiis haud
procul delitescunt : Solebat hac iter sepe facere · Stiradus nobilis eques
inter bohemos opibus et auctoritate potens : Et qui puellarum tirannidem
pre ceteris abhorreret : atque persequeretur : Is ergo cum siluam pro suo more
uenaturus intrasset : puellamque uinctam conspicatus esset : miserabundus
Quid sibi ea uellet percontatur Cui sarca nosti inquit : quot scelera
hiis in regionibus ualascha perpetrarit : dum sibi potencia regnumque
uendicat : Ego quoque pariter in furore acta insianiam eius aliquandiu :
secuta sum · pecaui fateor : penituit me tamen tot inepciarum denique :
Cogitauique quonam modo scelestem relinquere uitam possem : Statui
ab iniqua discedere domina  : Sed dum comitem fuge quero : prodita :
captaque huc deducor : hic de me supplicium summere statuerat sangwi¬
naria carnifex : Interea dum ligor : dumque michi ultima uerba dicuntur
auditus est tuorum canum latratus : atque hinnitus equorum : ille me
lanie salutem pedibus quesiere : at ego te uir clarissime : quem
unum perfida turba metuit per nobilitatem tuam oro miserere infelicis
femine Salue me obsecro atque abducito : aut si hoc non placet : iugula
me pocius : quam hic uiuam deseras : Namque ubi abieris mox aderit
iniqua uirginum cohors : meque diris lacerabunt modis : iuuat tua
manu perire : Stiradus lacrimis motus mulieribus puelleque forma
captus : equo desiliens : uincula soluat rogatque Medonis uasculum :
Smulque tuba apposita : quid sibi uelint : tum sarca medonem inquit
optomum carnifices attulerunt : quo inter cruciandum uterer : hunc
iam leta : securaque bibam · Et hausto sumpto : quod reliqum fuit
Stirado propinauit : qui pariter bibit : Erat autem potus suauissimus
quem bohemi ex albo melle conficiunt Sed quam mulieri saluber : herbis
ac carminibus adhibitis tam uiro pestilens : qui mentem Stiradi
prorsus alienauit Exin tuba he inquit mea fuit : dum uenarer
quam michi mortue ad collum suspendere statuerant pessime :
quasi uenatricis signum : inflabo : Vt intelligant : me uiuere : suisque
manibus ereptam esse : moxque tuba cecinit : ualascha ubi sonitum
