partem theutones ac bohemi : partem poloni atque hungari diripuerunt : Methodius
in bohemia : aliquamdiu moram traxit : deinde romam se contulit ubi fratrem suum
Cirillum comperit : qui baptzizato quodam Suatucupo : Morauis cristiana
sacra crediderat Multasque alias Sclauorum gentes ad fidem cristi conuerterat
ferunt cirillum cum rome aggeret : Romano pontifici supplicasse : ut sclauorum
lingua : Eius gentis hominibus quam baptisauerat : rem
diuinam faciens
uti posset : de qua re cum in sacro senatu disceptaretur : essentque non pauci
contradictores : auditam uocem tanquam de celo in hec uerba missam : omnis spiritus
laudet dominum ‧ Et omnis ligwa confiteatur ei indeque datum Cirillo indultum :
Borsinoius autem coniunxque Ludimilla : cristianam ueritatem amplexi : fidem
katholicam inter bohemos magnopere ampliarunt : Ludimilla filia fuit
comitis Slamborii castelle biczenie : quod postea melinca dictum est : Ex
ea tulit borsinoius duos filios ‧ Spitigneum et uratislaum Primus patri
successit : sed moriens sine filiis : fratri principatum reliquit ‧ Coniunx
uratislai drahomicia mulier audax : ad scelus prona : duos pariter
filios uno peperit wenczeslaum Et boleslaum : priorem tradidit ludimille
educandum : alterum ipsa enutriuit : alumni ex nutricibus mutuati mores
wenceslaus pietatem colere : Mansuetudinem pro se ferre : Cristiana sacra
uenerari : Elargiri multa pauperibus : nulli noxius esse : Boleslaus idolorum
sectari culturam : honores ambiciose querere : adulterari : Rapere : occidere :
In scelera cunta prolabi : pater suprema ordinans : ludimille cuius integritatem
prudenciamque optime nosset : quousque liberi adoleuissent : Gubernacionem prouincie
dimiserat : id egre drahomicie fuit Que thimam et simonem : nefarios
homines summittens : Socrum in castello : thetim strangulari iussit : ipsa
deinde Imperium accepit : in omnes crudelis : In cristianos seuissima et
intollerabilis : ac propterea eciam Venczeslao filio infesta : Cui preferre
fratrem non dubitauit : De Venczeslao hec referuntur : potus cibique parci¬
ssimum fuisse tradunt : Corporis maiestate decorum : Virginitatis ad
ultimum uite seruasse : diuina in templis officia : diuina nocturnaque
numquam neglexisse : Et noctis quidem tempore nudis pedibus : Super glaciem
ac niuem iter agentem uim frigoris minime sensisse : podium uero eius
comitem : Cum caligatus obriguisset : Iussum uestigia Venczeslai pedibus
premere : Concaluisse : postera die cruenta uiri sancti uestigia inuenta
Inisse eum iubente populo : adhuc uiuente matre principatum : duci uero
curmensi nulla
iniuria lacessito : cum exercitu bohemiam in¬
gresso atque agros uastare conanti armatum cum copiis occurrisse :
uocatoque in colloquium singulare certamen obtulisse : accepta ab ad¬
uersario condicione : ubi manus conferi debuit : angelos uisos : qui 
uenczeslaum protegentes : arma ministrarent : territum ea nouitate
Curmensem ex equo prolassum ueniam petiuisse : bohemum libenter humiliato
