re uisum est . Rectorem assummere : qui omnibus prsidens : imbecillos ac poten¬
ciores pari iure gubernaret : Erat per idem tempus inter bohemos uir nomine
Crocus : iusticie opinione insignis : ac propterea magne aput uulgus
auctoritatis : hunc sibi principem diligunt : summamque ei rerum com¬
mittunt : Cuius tanta moderatio fuit : ut non aliter quam pater a
prouincialibus coleretur : Neque enim ad suam uoluptatem : Sed pro subditorum
utilitate ac quiete prouinciam rexit : ferocemque populum : non tam imperio
quam beniuolencia : quietum continuit hic autem aput Stennam condidit :
quam de suo nomine crocouiam nuncupauit : Moriens autem tris filias
reliquit : brelam que castellum brelum exedificauit : herbarumque ac medicine
peritam : terbam siue terbicia : augurem : ac sortilegam : terciam libussiam
que ut natu minor fuit : ita diuinarum humanarumque rerum sciencia maior :
Hec ueluti una ex sibillis habita post obitum patris : fauente populo plu¬
ribus anni prouinciam gubernauit Et priusquam praga edificaretur arcem 
uicegradensem communit : fuitque suum imperium patribus plebique iuxta gratum
postremo non crudelitate aliqua non tirannide : aut secordia usa sed rectum 
iudicium faciens popularem fauorem obmisit : Contendebant coram ea : 
duo ex optimabus : de possessione agrorum : sentencia ex boue et equo
dicta : potencior humiliori dampnatus : ille tanquam iniuria esset : po¬
tenciorem in iudicio succumbere : populares appellans : indecorum esse
indignumque ait : tantum populum : tot proceres : tantum imperium : unius fe¬
mine subesse arbitrio : ad cuius uocem excitata multitudo : muliebre 
regimen accusare : uicinarum gencium mores in medium abducere : uirum
qui sibi dominetur expetere : libussa indicto silencio : desiderium se populi
animaduertisse dicit : neque se illos eo frustraturam : iubet ad idem posterum
redeant : obtemperatum est : tum atque reuentum · libussa in concione : ubi ad¬
esse multitudinem uidit Ego uobis inquit bohemi usque in hanc diem :
placide : moliterque : ut mulieribus mos est imperaui : Nulli quod suum
esset eripui : nullum lesi : Matrem experti estis : non dominam at
uobis meum regimen ingratum est : More humanii ingenii mecum
agitis : Nichil diu placet homini / piumque iustumque principem desiderant
populi : magis quam ferunt : Estote igitur iudicatu meo liberi : uerum qui
uobis presit : quique suo arbitratu capita uestra iudicet : sicut optastis :
dabo : Ite equm meum albicantem sternite : atque in campos late patentes 
adducite : Liberum effrenemque ibi dimittite : sequentes eum quoque iecit
Curret equus aliquandiu : denique ante uirum subsistet : in mensa ferrea
comedentem : ille michi coniunx erit : uobis princeps : Gratus sermo concioni
Emissus equus decem passuum percurrit postremo ad flumen bieli : ante
aratorem constitit nomine Primislau : Sequti proceres popularesque postquam
