pragam forte aduenientem : aggressus adalbertus : pontificialem ei chathedram
offert : Qui cum esset regis frater : Ex rege natus : facile populum sub religione
continere posset ‧ Nam sibi non esse facultatem eius regende plebis que
rapinis et adulteriis assueta : Ius easque omne contemneret : Stratiquas mun¬
danas dignitates : quasi malas pestes effugiendas esse : Respondit mo¬
nasterium sibi et presentem uitam suaem prestari : Et futuram promittere
meliorem : In eo
se uiuere morique uelle : Scribunt autores : adalber¬
tum hiis auditis prophetico spiritu plenum Stratiquati dixisse : poteras
modo pontificiali honore defungi ‧ cum salute defungi : At quod nunc
recusas : In perniciem tuam uehementer expetes : abisse deinde Romam :
ac cum fratre suo beate uite Gaudensio in monasterio sancti alexii
tamdiu delituisse : donec iussu pontificis maximi suas oues repetere
iussus est : Quibus cum esset prorsus ingratus in hungariam profectum
Regem Sthephanum
baptisasse quem inter sanctos relatum
aiunt : Exinde poloniam ingressum Gaudensium fratrem in ecclesia ges¬
nensi predicaturum ewangelium : pontificem ordinasse : postremo
prutenos adisse : aput quos dum cristi legem predicat : gladio cesum
martirio uitam finisse : Interea Stratiquatem mutato proposito pragensem
ecclesiam
poposcisse : neque repulsum paterno regioque fauore
adiutum : Sed aput Maguntinum archipresulem agit : Sacris de more
imbuendus inter duos episcopos iacentem pronum : diabolico spiritu arreptum
tamdiu uexatum donec animam exhalauit : deo dato nacionem theuthonicam
ecclesiam comissam : Boleslaus duobus et triginta annis imperio potitus
ex uita decessit : Relicto successor filio sui nominis boleslao tercio :
huic mescho polonorum princeps : Crocouiam per fraudem eripuit : bello deinde
orto uastatis agris : Inducie demum dicte : Statutumque uti ambo duces
apud crocouiam conuenirent : Boleslaus accepta fide eo pergit : atque in conuiuio
captus : luminibus priuatur : Comites eius crudeliter necati : exceptis
ursonicensibus : Insidiis consciis scribisque participibus : qui domum reuersi
tamquam magno ex periculo euasissent : publicam fidem atque iusiurandum
Et iura hospicii a polono uiolata queruntur : ubi fides habita : Ianurem
Boleslai fratrem dolo necare conantur : Cochares inter
ursoui¬
censes : consilio : opibus : auctoritate maior : adolescentem sub specie
uenacionis in siluas tractum : ad stipitem arboris alligatum : Sagittis
confodi iubet : fama est diuum iohannem baptistam precibus exoratum :
hirsuto tegmine sagittas excepisse : uxoremque eius per uisum commo¬
nuisse : periclitanti uero Vt opem ferret : Interea famulum principis
Onoram nomine : ex periculo prolapsum prodicionem populo exposuisse :
Illum tanta nouitate commotum correptis mox armis in siluam procurrisse
Captisque proditoribus atque occisis : ducem saluum reduxisse : In eo loco
