eius equo animo ferre non posse : Incredulitatem exprobrauit : qui factis
eloquis fidem non adhiberet : In quibus hec uerba potuisset aliquando
legisse : Cum te consumptum putaueris : oriens lucifer : Et habebis
fiduciam preposita tibi spe ‧ Et defessus securus dormies : Requiescens
nec erit qui te exterreat : Et deprecabuntur faciem tuam plurimi :
Subiungensque paruam eius esse fidem : atque inanem : Si mortem
iustorum miseram putaret : repente disparuit : Episcopus excitatus
uerba quidem sibi dicta : memorie tenuit ‧ Sed ubi nam scripta
essent in sacro codice prorsus ignorauit : Euoluto autem concor¬
danciarum libro undecimo apud iob : capitulo quod querebat : in¬
uenit ad tumultum autem insignis latro : Cum accessisset 
exprobrans mortuo uitam : lapide statue super sepulchrum
iacenti : Colaphum incussit ‧ Nec mora cecitate percussus : impietatis
sue penam dedit ‧ Statuo postmodum in sacrario erecta est : Et
alia enea loco eius reposita : iohannis brabantini egregii statuarii
nobile opus : Venczeslao filius eius successit : quamuis eodem nomine
moribus tamen longe dispar ‧ Qui cum ebrietati et turpissime parti
corporis dies : noctesque indulgeret : Et aliorum bona diriperet :
aliorum uxoribus illuderet : Aput olomuncium Morauie ciuitatem
dum solus in domo decani pontificialis edis perambulat : tribus
Wlneribus confossus duo deuiginti natus annos interiit : ignoratus
est necis autor : quamuis Conradus eques turingiis : Cruentum
gestans pugionem exire regiam uisus fuerit : Nam hiis prius
obtruncatus est populari tumultu : quam crimen confiteretur :
uenerat forte eo tempore pragam dux carinthie heinricus
Cui altera ex sororibus regis nomine anna nato maior : Iam pridem
nupserat hunc bohemi regem sibi deligunt : Id egre fert albertus
imperator : qui repente coactus copiis bohemiam ingressus : heinricum
regno deturbat : Rudolfumque filium suum regem constituit : Eisabet
senioris Venczeslai relicta in matrimonium ei tradita : quo regnum 
eius solidius esset : Qui cum magna bohemorum spe regnare cepisset :
Subitaneo morbo correptus : primo anno sui regni : absque liberis
decessit : Ob cuius obitum : diffidentes inter se bohemi : alii fredericum
rudolfi fratrem : alii heinricum quem deiecerant : pecierunt uicit
heinrici faccio : trucidatis alterius partis autoribus : Et quamuis albertus
imperator : Cum magnis copis bohemiam ingressus regionem longe
lateque afflixerit : henricum tamen regno deicere non potuit : prius
a nepote : ut ante diximus : occisu quam meditare in bohemos exequeretur
